LeapOSC Output Map
LEFT HAND
1. Left hand x-pos: lhp.x   (lhp = leap.getLeftHandPosition())
2. Left hand y-pos: lhp.y   (lhp = leap.getLeftHandPosition())
3. Left hand z-pos: lhp.z   (lhp = leap.getLeftHandPosition())
4. Left hand x-velocity: lhv.x   (lhv = leap.getLeftHandVelocity())
5. Left hand y-velocity: lhv.y   (lhv = leap.getLeftHandVelocity())
6. Left hand z-velocity: lhv.z   (lhv = leap.getLeftHandVelocity())
7. Left thumb x-pos: ltips[0].x  (ltips = leap.getLeftHandFingerTips()) (left thumb x-pos)
8. Left thumb y-pos: ltips[0].y  (ltips = leap.getLeftHandFingerTips()) (left thumb y-pos)
9. Left thumb z-pos: ltips[0].z  (ltips = leap.getLeftHandFingerTips()) (left thumb z-pos)
10. Left index x-pos: ltips[1].x  (ltips = leap.getLeftHandFingerTips()) (left index x-pos)
11. Left index y-pos: ltips[1].y  (ltips = leap.getLeftHandFingerTips()) (left index y-pos)
12. Left index z-pos: ltips[1].z  (ltips = leap.getLeftHandFingerTips()) (left index z-pos)
13. Left middle x-pos: ltips[2].x  (ltips = leap.getLeftHandFingerTips()) (left middle x-pos)
14. Left middle y-pos: ltips[2].y  (ltips = leap.getLeftHandFingerTips()) (left middle y-pos)
15. Left middle z-pos: ltips[2].z  (ltips = leap.getLeftHandFingerTips()) (left middle z-pos)
16. Left ring x-pos: ltips[3].x  (ltips = leap.getLeftHandFingerTips()) (left ring x-pos)
17. Left ring y-pos: ltips[3].y  (ltips = leap.getLeftHandFingerTips()) (left ring y-pos)
18. Left ring z-pos: ltips[3].z  (ltips = leap.getLeftHandFingerTips()) (left ring z-pos)
19. Left pinky x-pos: ltips[4].x  (ltips = leap.getLeftHandFingerTips()) (left pinky x-pos)
20. Left pinky y-pos: ltips[4].y  (ltips = leap.getLeftHandFingerTips()) (left pinky y-pos)
21. Left pinky z-pos: ltips[4].z  (ltips = leap.getLeftHandFingerTips()) (left pinky z-pos)
22. Left hand size: lohs    (lohs = leap.getLeftOpenHandSize())
23. Left hand x-normal: lhn.x   (lhn = leap.getLeftHandNormal())
24. Left hand y-normal: lhn.y   (lhn = leap.getLeftHandNormal())
25. Left hand z-normal: lhn.z   (lhn = leap.getLeftHandNormal())
26. Left hand x-direction: lhd.x   (lhd = leap.getLeftHandDirection())
27. Left hand y-direction: lhd.y   (lhd = leap.getLeftHandDirection())
28. Left hand z-direction: lhd.z   (lhd = leap.getLeftHandDirection())
29. Left hand roll: lhr     (lhr = leap.getLeftHandRoll())
30. Left hand pitch: lhpt    (lhpt = leap.getLeftHandPitch())
31. Left hand yaw: lhw     (lhw = leap.getLeftHandYaw())

RIGHT HAND
32. Right hand x-pos: rhp.x   (rhp = leap.getRightHandPosition())
33. Right hand y-pos: rhp.y   (rhp = leap.getRightHandPosition())
34. Right hand z-pos: rhp.z   (rhp = leap.getRightHandPosition())
35. Right hand x-velocity: rhv.x   (leap.getRightHandVelocity())
36. Right hand y-velocity: rhv.y   (leap.getRightHandVelocity())
37. Right hand z-velocity: rhv.z   (leap.getRightHandVelocity())
38. Right thumb x-pos: rtips[0].x  (rtips = leap.getRightHandFingerTips()) (right thumb x-pos)
39. Right thumb y-pos: rtips[0].x  (rtips = leap.getRightHandFingerTips()) (right thumb y-pos)
40. Right thumb z-pos: rtips[0].x  (rtips = leap.getRightHandFingerTips()) (right thumb z-pos)
41. Right index x-pos: rtips[1].x  (rtips = leap.getRightHandFingerTips()) (right index x-pos)
42. Right index y-pos: rtips[1].y  (rtips = leap.getRightHandFingerTips()) (right index y-pos)
43. Right index z-pos: rtips[1].z  (rtips = leap.getRightHandFingerTips()) (right index z-pos)
44. Right middle x-pos: rtips[2].x  (rtips = leap.getRightHandFingerTips()) (right middle x-pos)
45. Right middle y-pos: rtips[2].y  (rtips = leap.getRightHandFingerTips()) (right middle y-pos)
46. Right middle z-pos: rtips[2].z  (rtips = leap.getRightHandFingerTips()) (right middle z-pos)
47. Right ring x-pos: rtips[3].x  (rtips = leap.getRightHandFingerTips()) (right ring x-pos)
48. Right ring y-pos: rtips[3].y  (rtips = leap.getRightHandFingerTips()) (right ring y-pos)
49. Right ring z-pos: rtips[3].z  (rtips = leap.getRightHandFingerTips()) (right ring z-pos)
50. Right pinky x-pos: rtips[4].x  (rtips = leap.getRightHandFingerTips()) (right pinky x-pos)
51. Right pinky y-pos: rtips[4].y  (rtips = leap.getRightHandFingerTips()) (right pinky y-pos)
52. Right pinky z-pos: rtips[4].z  (rtips = leap.getRightHandFingerTips()) (right pinky z-pos)
53. Right hand size: rohs    (rohs = leap.getRightOpenHandSize())
54. Right hand x-normal: rhn.x   (rhn = leap.getRightHandNormal())
55. Right hand y-normal: rhn.y   (rhn = leap.getRightHandNormal())
56. Right hand z-normal: rhn.z   (rhn = leap.getRightHandNormal())
57. Right hand x-direction: rhd.x   (rhd = leap.getRightHandDirection())
58. Right hand y-direction: rhd.y   (rhd = leap.getRightHandDirection())
59. Right hand z-direction: rhd.z   (rhd = leap.getRightHandDirection())
60. Right hand roll: rhr     (rhr = leap.getRightHandRoll())
61. Right hand pitch: rhpt    (rhpt = leap.getRightHandPitch())
62. Right hand yaw: rhw     (rhw = leap.getRightHandYaw())
